apesadumbrado - consternado / triste
melancólico - melancólico
deprimido - deprimido
desanimado - desanimado
abatido - abatido
desalentado - desalentado
consternado - consternado
triste - triste
animado - animado
comer - comer
cocinar - cozinhar
preparar - preparar
servir - servir
servido - servido
sirviendo - servindo
servidor - servidor
probar - probar
masticar - mastigar
beber - beber
saborear - saborear
devorar - devorar
asar - assar
asado - assado
asando - assando
asador - assador
cocinero - cozinheiro
cocinera - cozinheira
comilón - comilão
comilona - comilança
comida - comida
comiendo - comendo
comido - comido
comedor - comedor
comestible - comestível
comible - comível
bebida - bebida
bebido - bebido
bebiendo - bebendo
bebedor - bebedouro
por error - por engano
dar la vuelta - dar a volta
horno - forno
jugoso - suculento
jugosa - suculenta
jugosidad - suculência
crujiente - crocante
filete - bife
bocado - mordida
tomar un bocado - dar uma mordida
tomar el autobus - pegar o ônibus
salmón - salmão
pescado - peixe
ajetreo - agitação / correria
ajetreado - agitado
ajetreada - agitada
fortuna - fortuna
riqueza - riqueza
éxito - êxito
exitoso - bem-sucedido
exitosa - bem-sucedida
opulencia - opulência
opulento - opulento
opulenta - opulenta
prosperidad - prosperidade
próspero - próspero
próspera - próspera
prosperar - prosperar
prosperado - prosperado
prosperando - prosperando
rico - rico
rica - rica
pobre - pobre
adinerado - endinheirado
adinerada - endinheirada
dinero - dinheiro
